.############
#P.D.D.D.D.D#
#.#########.#
#D#DDDDDDD#D#
#.#.DDEDD.#.#
#DE.DDODD.ED#
#.#.DDEDD.#.#
#D#DDDDDDD#D#
#.#########.#
#D.D.D.D.D.D#
.############