.############
#P.DD.D.D.DD#
#.#D#D#D#.#D#
#DD.D..DDDD.#
#D#.#D#.#D#.#
#D.DD.E.D.D.#
#.#D#.#D#D#.#
#D.DDD..DD.D#
#.#.#.#.#.#D#
#.DDD.D.D.DO#
.############