.############
#P.DD.D..DD.#
#.#D#####D#D#
#D#DD.E.D.#.#
#D#.D#D#DD#D#
#.EDD#O#.DE.#
#D#D.#D#DD#D#
#.#.DDE.DD#.#
#D#D#####D#D#
#DDD..D.DDD.#
.############